Many, many, many, many, many rockets...
100
....................
R..W...........X....
...--..W.......--...
....W.--........W..R
...--..........--...
R..W......W....W....
...--....--....--...
....W...........W...
...--........W.--...
R..W........--.W....
...f-..........--...
....W...........W..R
...--..........--...
.1..................
######..####..######