Pick up all the water drops and reach the exit in time.
10
......................................
.................X....................
..........##########..................
......................................
WWW....WWWW...........................
---....####...........................
.....................####.............
WWW...................................
###.........WWWWW.....................
............#####..........#####......
....WWW...............................
....###..............####.............
......................................
.1........W.W.W.W.W...................
##F#######################...#########