When Sparky drops down, better get out of the way.
....................
..........X.........
........-----.......
....................
..C...W.W.W.W.W..C..
..-------f--------..
.W..................
---.W...........W...
....-...........-...
....................
.S..W.....W......S.W
---.............----
....................
.1.....S.....W......
###...###...###.....