Use the turtle to jump higher, but watch out!
....................
R..W.W.W.......W.W.W
iiiiiiii............
.............---....
....................
........---.......X.
................----
........C...........
......-------.......
................W..R
...............fh...
W..T..........W.....
hhhhh.........hh....
.1..............W...
#######......iiiii..